NO ./textures/wall_02.xpm
SO ./textures/wall_03.xpm
WE ./textures/wall_04.xpm
EA ./textures/wall_06.xpm


F 147, 145, 124
C 65,               56, 57


1111111
1000111
1100001
1111111
11
      111111111
    11000000011
   1100000000011
   100011111111111
 11110011111011111
110010011111101111
11001000000000001
11001000000000001
1100100000N000001
11001000000000001
11001000000000001
 1111000011110001
    100001 100001
    100001 100001
    111111 111111
