NO ./textures/wall_02.xpm
SO ./textures/wall_03.xpm
WE ./textures/wall_04.xpm
EA ./textures/wall_06.xpm

F 10, 10, 60

C 24, 6, 12


         111         111      111       111         111111111    1111111  111     111111     111
        11S11        101111   101      11011        101111101   111   111 101     101 111    111
       11000111      101 111  101     11000111      101   101  111        101     101  111  111
      11000001111    101  111 101    11000001111    101   101 111         10111111101   111 111
     1000000000001   101   111101   1000000000011   10111 101 111         10111111101    11111
    100111111111001  101    11101  100111111111011  10111111   111        101     101     101
   1001         1001 101     1101 11011       10011 101  1111   111   111 101     101     101
  1001           1001101      1011100111       10011101    1111  1111111  101     101     101 
 1001111111111111100001111111100000111111111111101110111111111111111111111101111111011111111111111
 1000000000000000000000000000000000000000000000000000000000000000000000000000000000000000000000001
 1111111111111111111111111111111111111111111111111111111111111111111111111111111111111111111111111