        11111111111
        10000000101
        10110000101
        10010000001
1111111111001110001
1000011000001110111
1110111111111010001
1110111111111011101
1000000000000001101
1000001101010010001
10001110101010N0111
1110111 10011010001
111111 111111111111