NO ./textures/wall_02.xpm
SO ./textures/wall_03.xpm
WE ./textures/wall_04.xpm
EA ./textures/wall_06.xpm

F 147, 145, 124
C 65, 56, 57

1111111111111111111
1111111110000000101
1111111110110000101
1111111110010000001
1111111111001110001
1000011000001110111
1110111111111010001
1110111111111011101
1000000000000001101
1000001101010010001
10001110101010S0111
1110111100110100011
1111111111111111111
