NO ./textures/wall_02.xpm
SO ./textures/wall_03.xpm
WE ./textures/wall_04.xpm
EA ./textures/wall_06.xpm

F 143, 145, 124
C 65, 56, 57


111111111111111
1111111111111
111111111
111
       11111111111111111
11111111000S001011111111111111
1111100000110000101111111111111
11110000000100000011111111111111111
11110000001110001111111
111111110000111111111111
1000011000001110111
1110111000001010001111111
1110111000000011101111111
1111111111111111101
1000000000000001101111111
1000001101010010001
1000111010101000111111111
1010111100110100011111111
1111111111111111111111111
