11111
100101
101N0111
11001111
11111111