NO ./textures/wall.xpm
SO ./textures/wall.xpm
WE ./textures/wall_2.xpm
EA ./textures/wall_2.xpm

F 147, -145f, 124
C 255, 0, 0, 8

lol
weird shit
still not a one

11111
10001
11N11
10101
11111