NO ./textures/wall.xpm
SO ./textures/wall.xpm
WE ./textures/wall_2.xpm
EA ./textures/wall_2.xpm

F 147, 145, 124
C 147, 145, 124


 11111
11001
11N11
10101
11111