NO ./textures/wall.xpm
SO ./textures/wantedwall.xpm
WE ./textures/wall.xpm
EA ./textures/wall.xpm

F 255, 205, 87

C 87, 207, 255

111111111111111111111111111
111111111111000000000000001
101100000111000000000000111
100100000000000000111111111
111111111011001001110000111
100000000011011001110111111
11110111111111S111000000111
111101111111110111010100111
110000001101010111000000001
100000000000000011000000111
100000000000000011010100001
110000011101111101111000111
11110111 1110101101111010001
11111111 1111111111111111111