NO ./textures/wall_02.xpm
SO ./textures/wall_03.xpm
WE ./textures/wall_04.xpm
EA  ./textures/wall_06.xpm

F 0, 0, 0

C 255, 255, 255

111111111111111111111111111
111111111111000000000000001
101100000111000000000000111
100100000000000000111111111
111111111011000001110000111
100000000011000001110111111
11110111111111N111000000111
111101111111110111010100111
110000001101010111000000001
100000000000000011000000111
100000000000000011010100001
110000011101111101111000111
11110111 1110101101111010001
11111111 1111111111111111111