NO ./textures/wall.xpm
SO ./textures/wall.xpm
WE ./textures/wall.xpm
EA ./textures/wall.xpm

F 220,100,0
C 225,30,0

111111111111111111111111111
111111111111000000000000001
101100000111000000000000111
100100000000000000111111111
111111111011000001110000111
100000000011000001110111111
111101111111110111000000111
111101111111110111010100111
110000001101010111000000001
100000000000000011000000111
100000000000000011010100001
1100000111011111011110N0111
11110111 1110101101111010001
11111111 1111111111111111111