NO ./textures/wall_01.xpm
SO ./textures/wall_02.xpm
WE ./textures/wall_03.xpm
EA ./textures/wall_04.xpm

F 147, 127, 124
C 65, 56, 57



111111
1001011
101001
1100N11
111111
