NO ./textures/wall.xpm
SO ./textures/wantedwall.xpm
WE ./textures/wall.xpm
EA ./textures/wall.xpm

F 255, 205, 87

C 87, 207, 255

1111111111111111111111111
1000000000110000000000001
1011000001110000000000001
100100000000000000000000111111111
111111111011000001110000000000001
100000000011000001110111111111111
11110111111111011100000010001
11110111111111011101010010001
11000000110101011100000010001
10000000000100001100000010001
10000000001 100001101010010001
11000001110101011111011110N01
11110111111101011101011010001
11111111111111111111011110111
        111111111111011110111
        111111111111011110111
        11111 11111100000111111111
        11111 11111111111111111111