NO ./textures/wood.xpm
SO ./textures/wood.xpm
WE ./textures/wood.xpm
EA ./textures/wood.xpm

F 128, 128, 128
C 0,      255, 255

1111111111111111111
1111111110000000101
1111111110110000101
1111111110010000001
1111111111001110001
1000011000001110011
1111111111111010001
1110111111111011101
1000000000000001101
1000001101010010001
10001110101010S0111
1110111100110100011
1111111111111111111
